border_size=1
usage=map

Gd          , Gd          , Gs^Es       , Rb          , Gs          , Rp          , Gs          , Rb          , Gll         , Gll         , Gs          , Gs          , Rr^Vhc      , Gs          , Gs          , Gs          , Gs          , Re          , Re          , Gs          , Rr          , Rrc         , Rrc         , Gs          , Re          , Re          , Gs          , Gs          , Gs          , Re          , Rb          , Re          , Rr^Vhc      , Gs          , Gd          , Rrc         , Gs          , Gs          , Re          , Gs          , Re          , Re          , Xv          , Xv          , Xv          , Xv          , Xv          , Xv          , Xv          , Xv          
Re          , Rb          , Re          , Gd          , Gs          , Rr          , Gs          , Gs          , Rr^Vhc      , Rr^Vhc      , Gs^Es       , Gs          , Rr          , Gs          , Gs          , Rr^Vhc      , Rr^Vhc      , Gs          , Gd          , Gs          , Rrc         , Rrc         , Rrc         , Gs          , Gd          , Gd          , Rr^Vhc      , Rp          , Rr          , Gs^Es       , Gs          , Re          , Rr^Vhc      , Rr^Vhc      , Gs          , Rrc         , Rr          , Rr^Vhc      , Rr^Vhc      , Gs^Es       , Gd          , Gd          , Xv          , Xv          , Xv          , Xv          , Xv          , Xv          , Xv          , Xv          
Kh          , Kh          , Kh          , Gll         , Rr^Vhc      , Rr^Vhc      , Gd          , Gd          , Gs          , Rr^Vhc      , Rr          , Gd          , Gd          , Rr          , Rr          , Rr^Vhc      , Gs          , Rp          , Rr          , Gs          , Rrc         , Rr          , Rrc         , Gs          , Rrc         , Rr^Vhc      , Rr^Vhc      , Gs          , Re          , Rr^Vhc      , Rr          , Rr          , Gs          , Gd          , Rr^Vhc      , Rp          , Re          , Rr^Vhc      , Re          , Gs          , Kh          , Gs          , Xv          , Xv          , Xv          , Xv          , Xv          , Xv          , Xv          , Xv          
Kh          , Ch          , Kh          , Re          , Gs          , Rr^Vhc      , Rr          , Gs^Es       , Rr^Vhc      , Gs          , Gll         , Rr^Vhc      , Rr^Vhc      , Rp          , Gs          , Gs          , Gd          , Gll^Es      , Rr^Vhc      , Rr          , Rrc         , Rrc         , Rr          , Rr          , Gs^Es       , Gll         , Rr          , Gs          , Rr^Vhc      , Rrc         , Gd          , Rr          , Rp          , Rr^Vhc      , Rr^Vhc      , Gs^Es       , Gd          , Rb          , Gll         , Kh          , Ch          , Kh          , Xv          , Xv          , Xv          , Xv          , Xv          , Xv          , Xv          , Xv          
Wog         , Kh          , Ch          , Ch          , Ch          , Gll         , Rb          , Rp          , Rrc         , Rrc         , Rr          , Rr^Vhc      , Gs          , Rp          , Rr          , Rr          , Rrc         , Rr^Vhc      , Rr^Vhc      , Gs          , Rr          , Rrc         , Rrc         , Gs          , Gd          , Gs          , Gs          , Rr^Vhc      , Rr^Vhc      , Gs          , Rr^Vhc      , Rr          , Gd          , Gs          , Gll         , Gd          , Re          , Gll         , Ch          , Kh          , Kh          , Kh          , Xv          , Xv          , Xv          , Xv          , Xv          , Xv          , Xv          , Xv          
Wog         , Wog         , Wog         , Ch          , Ch          , Ch          , Ch          , Re          , Gs          , Gs^Es       , Gd          , Gd          , Rb          , Gs          , Gd          , Gs          , Gll         , Re          , Gs          , Gs          , Rrc         , Rrc         , Rr          , Gs          , Rb          , Re          , Rb          , Gs          , Gs          , Re          , Re          , Gs          , Re          , Re          , Rb          , Re          , Ch          , Ch          , Ch          , Ch          , Wog         , Wog         , Xv          , Xv          , Xv          , Xv          , Xv          , Xv          , Xv          , Xv          
Wwg         , Wog         , Wwg         , Wwg         , Wog         , Ch          , Ch          , Ch          , Ch          , Re          , Kh          , Re          , Ch          , Ch          , Ch          , Ch          , Ch          , Ch          , Ch          , Kh          , Rrc         , Rrc         , Rrc         , Kh          , Ch          , Ch          , Ch          , Ch          , Ch          , Ch          , Ch          , Gll         , Kh          , Re          , Ch          , Ch          , Ch          , Ch          , Wog         , Wog         , Wwg         , Wwg         , Xv          , Xv          , Xv          , Xv          , Xv          , Xv          , Xv          , Xv          
Gg          , Wwg         , Wwf         , Wwg         , Wog         , Wog         , Wog         , Ch          , Ch          , Kh          , Ch          , Kh          , Ch          , Ch          , Ch          , Ch          , Ch          , Ch          , Ch          , Kh          , Rr          , Rrc         , Rp          , Kh          , Ch          , Ch          , Ch          , Ch          , Ch          , Ch          , Ch          , Kh          , Ch          , Kh          , Ch          , Ch          , Wog         , Wog         , Wog         , Wog         , Wwg         , Wwg         , Xv          , Xv          , Xv          , Xv          , Xv          , Xv          , Xv          , Xv          
Gg          , Ds          , Ds          , Wwf^Ewl     , Wwg         , Wog         , Wog         , Wog         , Wog         , Kh          , Kh          , Kh          , Wog         , Wog         , Wog         , Wog         , Wog         , Wog         , Wog         , Wog         , Wog^Bsb|    , Wog^Bsb|    , Wog^Bsb|    , Wog         , Wog         , Wog         , Wog         , Wog         , Wog         , Wog         , Wog         , Kh          , Kh          , Kh          , Wog         , Wog         , Wog         , Wog         , Wwg         , Wwg         , Gg          , Ds          , Xv          , Xv          , Xv          , Xv          , Xv          , Xv          , Xv          , Xv          
Gs          , Gg          , Gs          , Ds          , Ds          , Wwg         , Wwg         , Wog         , Wog         , Wog         , Wog         , Wog         , Wog         , Wog         , Wog         , Wog         , Wog         , Wog         , Wog         , Wog         , Wog^Bsb|    , Wog^Bsb|    , Wog^Bsb|    , Wog         , Wog         , Wog         , Wog         , Wog         , Wog         , Wog         , Wog         , Wog         , Wwg         , Wwg         , Wog         , Wog         , Wwg         , Wwg         , Gg          , Gg          , Gg          , Gg          , Xv          , Xv          , Xv          , Xv          , Xv          , Xv          , Xv          , Xv          
Gs          , Gs          , Gs          , Ds          , Ds          , Ds          , Gg          , Wwg         , Wwg         , Wwg         , Wwg         , Wog         , Wwg         , Wog         , Wwg         , Wog         , Wwg         , Wog         , Wwg         , Wwg         , Wwg^Bsb|    , 3 Wog^Bsb|  , Wwg^Bsb|    , Wog         , Wwg         , Wog         , Wwg         , Wwg         , Wwg         , Wog         , Wwg         , Wwg         , Wwg         , Wwg         , Wwf^Ewl     , Wwg         , Ds          , Ds          , Gs          , Gs          , Gg          , Gs          , Xv          , Xv          , Xv          , Xv          , Xv          , Xv          , Xv          , Xv          
Hhd         , Gg          , Gg          , Gs          , Gg          , Gs          , Gs          , Gg          , Gg          , Wwg         , Ds          , Wwg         , Gg          , Wwg         , Gg          , Wwg         , Ds          , Wwg         , Ds          , Wwg         , Rr          , Wwg^Bsb|    , Rr          , Wwg         , Gg          , Wwg         , Ds          , Wwg         , Gg          , Wwg         , Ds          , Wwg         , Ds          , Wwf         , Ds          , Ds          , Gg          , Ds          , Gs          , Gs          , Gs          , Gs          , Xv          , Xv          , Xv          , Xv          , Xv          , Xv          , Xv          , Xv          
Hhd         , Gg          , Hhd         , Gs          , Gs          , Gg          , Gs          , Gg          , Gg          , Ds          , Ds          , Ds          , Gs          , Gg          , Gg          , Ds          , Ds          , Ds          , Gg          , Gg          , Rr          , Rr          , Rr          , Gg          , Gg          , Gg          , Gs          , Ds          , Gs          , Gg          , Gs          , Ds          , Gg          , Ds          , Gs          , Gg          , Gs          , Gs          , Gg          , Gg          , Gs          , Gs          , Xv          , Xv          , Xv          , Xv          , Xv          , Xv          , Xv          , Xv          
Gs          , Hhd         , Hhd         , Gs          , Gs          , Gg          , Gd          , Gs          , Gs          , Ds          , Gs          , Gs          , Gs          , Gs          , Gg          , Gs          , Gs          , Gs          , Gs          , Gs          , Rb          , Rr          , Rr          , Gg          , Gs          , Gs          , Gs          , Gs          , Gs          , Gs          , Gs          , Gg          , Gs          , Gs          , Gg          , Gs          , Gs          , Gs          , Gd          , Gg          , Gg          , Gs          , Xv          , Xv          , Xv          , Xv          , Xv          , Xv          , Xv          , Xv          
Gs          , Gg          , Gs          , Gs          , Gd          , Re^Vh       , Gd^Gvs      , Gs^Wm       , Gs          , Gs          , Gs          , Gg          , Gg          , Gg          , Gg          , Gs          , Gs          , Gd          , Gs          , Gs          , Rb          , Rr          , Rb          , Gd          , Gs^Vc       , Gg          , Gs          , Gs          , Gg          , Gg          , Gg          , Gs          , Gs          , Gg          , Gg          , Gll         , Gs          , Gs          , Gg          , Gll         , Gll         , Gs          , Xv          , Xv          , Xv          , Xv          , Xv          , Xv          , Xv          , Xv          
Gs          , Gs          , Gg          , Gs          , Re^Gvs      , Re^Gvs      , Gd^Gvs      , Gd^Gvs      , Gd^Gvs      , Re          , Gs          , Gs          , Gs          , Gs          , Gll         , Gll         , Gg          , Gs          , Gs          , Gs          , Rr          , Rb          , Rr          , Gd          , Gg          , Gg          , Gg          , Gs          , Gs          , Gs          , Gs          , Gs          , Gs          , Gg          , Gg          , Gs          , Gd^Gvs      , Gg          , Gs          , Gll         , Gs          , Gs          , Xv          , Xv          , Xv          , Xv          , Xv          , Xv          , Xv          , Xv          
Gs          , Gs          , Gs          , Re^Gvs      , Re^Gvs      , Re^Gvs      , Re^Gvs      , Re^Gvs      , Re^Gvs      , Gd^Gvs      , Gs          , Gg          , Gs          , Gs          , Gs          , Gg          , Gs          , Gs          , Gs          , Gs          , Rr          , Rb          , Rb          , Gs          , Gd          , Gs          , Gs          , Gs          , Gs          , Gs          , Gg          , Gs          , Gd          , Re^Vh       , Rb^Gvs      , Gd^Gvs      , Rb^Gvs      , Gs          , Gs          , Gs          , Gg          , Gs          , Xv          , Xv          , Xv          , Xv          , Xv          , Xv          , Xv          , Xv          
Gs          , Gd          , Gs          , Gs          , Gg          , Re^Gvs      , Re^Gvs      , Re^Gvs      , Re^Vh       , Gd^Wm       , Gs          , Gg          , Gs          , Gs          , Re          , Gd          , Re^Gvs      , Re^Vh       , Gs          , Gd          , Rb          , Rb          , Rb          , Gs          , Gs          , Gg          , Gll         , Gs          , Gg          , Gg          , Gg          , Gs          , Rb^Gvs      , Rb^Gvs      , Rb^Gvs      , Rb^Gvs      , Rb^Gvs      , Re^Vh       , Gs          , Gg          , Gs          , Gs          , Xv          , Xv          , Xv          , Xv          , Xv          , Xv          , Xv          , Xv          
Gs          , Gs          , Gs          , Gd          , Gs          , Gg          , Re          , Gd          , Gs          , Gs          , Gs          , Gs          , Gs          , Gs          , Re^Gvs      , Re^Gvs      , Re^Gvs      , Re^Gvs      , Gs          , Gs          , Rb          , Rr          , Rb          , Gs          , Gs          , Gll         , Gd          , Gd          , Gs          , Gs          , Gs          , Gs^Wm       , Rb^Gvs      , Rb^Gvs      , Gd^Gvs      , Rb^Gvs      , Gd          , Gs          , Gs          , Gs          , Hhd         , Hhd         , Xv          , Xv          , Xv          , Xv          , Xv          , Xv          , Xv          , Xv          
Gg          , Gg          , Gg          , Gs          , Gg          , Gs          , Gs          , Gs          , Gg          , Gg          , Gg          , Gs          , Gs          , Gd          , Re^Gvs      , Re^Gvs      , Gd^Gvs      , Gd^Gvs      , Gs          , Gs          , Rb          , Rb          , Rr          , Gs          , Gs          , Gs          , Gd          , Gs          , Gs          , Gs          , Gd          , Gs          , Rb^Gvs      , Rb^Gvs      , Re          , Re          , Gs          , Gs          , Gs          , Hhd         , Gd          , Hhd         , Xv          , Xv          , Gd          , Gs          , Hh^Fms      , Xv          , Xv          , Xv          
Gs          , Gg          , Gs          , Gs          , Gs          , Gs          , Gg          , Gs          , Gs          , Gs          , Gs          , Gs          , Gs          , Re^Vh       , Gd^Gvs      , Gd^Gvs      , Gd^Wm       , Gs          , Gg          , Gs          , Rb          , Rb          , Rb          , Gs          , Gs          , Gg          , Gs          , Gs          , Gs          , Gg          , Gs          , Gs          , Gll         , Re          , Gs          , Gs          , Gs          , Gs          , Gs          , Gs          , Gs          , Gs          , Xv          , Gs          , Gs          , Gs          , Gg          , Gs          , Xv          , Xv          
Gs          , Gll         , Gs          , Gd          , Gd          , Gll         , Gs          , Gll         , Re          , Gs          , Gg          , Gs          , Gs          , Gs          , Gs          , Gd          , Gg          , Gg          , Gs          , Gd          , Rp          , Rp          , Rb          , Rb          , Gs          , Gs          , Gg          , Gs          , Gs          , Gs          , Gs          , Gs          , Gll         , Gg          , Gd          , Gs          , Gs          , Gd          , Gd          , Gs          , Gs          , Gs          , Xv          , Gd          , Gd          , Gs          , Gs          , Gg          , Xv          , Xv          
Gg          , Gs          , Gg          , Gg          , Gs          , Gs          , Gg          , Re          , Gd          , Gd          , Gs          , Gs          , Gd          , Gs          , Gs          , Gg          , Gll         , Gll         , Gs          , Gs          , Gs          , Rp          , Rb          , Rb          , Rb          , Gs          , Gd          , Gg          , Gs          , Gs^Vc       , Gg          , Gs          , Gs          , Gd          , Gs          , Gs          , Gs          , Gs          , Gs          , Gll         , Gg          , Gs^Fds      , Xv          , Hhd         , Hhd         , Gs          , Gll         , Gs          , Xv          , Xv          
Gs          , Gs          , Gs          , Gs          , Gs          , Gs          , Gs          , Gg          , Gs          , Gg          , Gs          , Gs          , Gs          , Gs          , Gs          , Gs          , Gs          , Gs          , Gs          , Gs          , Gs          , Rb          , Rp          , Rb          , Rb          , Gs          , Gs          , Gs          , Gs          , Gs          , Gg          , Gs          , Gll         , Gs          , Gg          , Gg          , Gg          , Gs          , Gg          , Gs          , Gs^Fds      , Gg          , Xv          , Xv          , Xv          , Gs          , Xv          , Xv          , Xv          , Xv          
Gs          , Gs          , Gg          , Gs^Vc       , Gg          , Gs          , Gs          , Gs          , Gs          , Gs          , Gs          , Gs          , Gs          , Gs          , Gs          , Gs          , Gs          , Gg          , Gg          , Gs          , Gs          , Gs          , Rp          , Rb          , Rb          , Gs          , Gs          , Gd          , Gs          , Gs          , Gs          , Gs          , Gs          , Gs          , Gs          , Gs          , Gs^Fds      , Gs          , Gs          , Gs^Fds      , Gs^Fms      , Gs^Fds      , Xv          , Xv          , Xv          , Xv          , Xv          , Xv          , Xv          , Xv          
Gs          , Gs          , Gd          , Gd          , Gg          , Gs          , Gll         , Gs          , Gll         , Gs          , Gs          , Gs          , Gg          , Gs          , Gs          , Gs          , Gs          , Gs          , Gs          , Gs^Fds      , Gg          , Gd          , Rb          , Rb          , Rp          , Gs          , Gs          , Gs          , Gg          , Gg          , Gg          , Gs          , Gg          , Gs          , Gs          , Gg          , Gs^Fms      , Gs^Fds      , Gs          , Gg          , Gs^Fds      , Gg          , Xv          , Xv          , Xv          , Xv          , Xv          , Xv          , Xv          , Xv          
Hhd         , Gs          , Gs          , Gs          , Gg          , Gg          , Gs          , Gs          , Gg          , Gs          , Gg          , Gs          , Gs          , Gs          , Hh          , Gg          , Gg          , Hh          , Hh^Fds      , Gg          , Gg          , Gd          , Rb          , Rb          , Rb          , Hh^Fds      , Hh^Fds      , Gs          , Gs          , Hh          , Gs          , Hh^Fds      , Gg          , Gg          , Gg          , Gs^Fds      , Gg          , Gs          , Gs^Fms      , Gs^Fms      , Gs^Fds      , Gs^Fds      , Xv          , Xv          , Xv          , Xv          , Xv          , Xv          , Xv          , Xv          
Hhd         , Hhd         , Gs          , Gs          , Gs          , Gs          , Gs          , Gs          , Gs          , Gs          , Gg          , Gs          , Gg          , Hh          , Gs^Fds      , Hh          , Gg          , Hh^Fms      , Gs          , Gs          , Hh^Fms      , Hh^Fms      , Rp          , Rb          , Rb          , Rb          , Gg          , Gg          , Hh          , Gg          , Hh^Fds      , Gs^Fds      , Gs          , Gs^Fds      , Gs          , Gs          , Gg          , Gg          , Gs^Fds      , Gs^Fds      , Gs^Fms      , Gs^Fds      , Xv          , Xv          , Xv          , Xv          , Xv          , Xv          , Xv          , Xv          
Gs          , Gs          , Gd          , Gs          , Gs          , Gs          , Gd          , Gs          , Gs          , Gs          , Gs^Vc       , Gs          , Gg          , Gs^Fms      , Gg          , Gs          , Hh^Fds      , Gg          , Gg          , Hh^Fds      , Hh^Fds      , Hh^Fds      , Hh^Fds      , Rb          , Rb          , Rb          , Hh^Fds      , Hh^Fds      , Hh^Fms      , Hh^Fds      , Hh          , Gs          , Gg          , Gg          , Gs^Fds      , Gs^Fds      , Gs^Fds      , Gs^Fds      , Gs^Fds      , Gs^Fds      , Gs^Fds      , Gs^Fms      , Xv          , Xv          , Xv          , Xv          , Xv          , Xv          , Xv          , Xv          
Gs          , Gs          , Gs          , Gs          , Gg          , Gd          , Gd          , Gd          , Gs          , Gd          , Gs          , Gs          , Gs          , Gg          , Gg          , Gg          , Gg          , Gs          , Gg          , Hh          , Gs^Vl       , Gg          , Gs          , Rb          , Rb          , Rp          , Gs          , Hh          , Gg          , Hh^Fms      , Gs          , Gg          , Gs          , Gs^Fds      , Gs^Fds      , Gs^Fms      , Gs^Fds      , Gs^Fds      , Gs^Fms      , Gs^Fms      , Gs^Fds      , Gs^Fds      , Xv          , Xv          , Xv          , Xv          , Xv          , Xv          , Xv          , Xv          
Gs          , Gll         , Gll         , Gll         , Gs          , Gs          , Re          , Re          , Gs          , Gs          , Gg          , Gs          , Gs          , Gs          , Gs          , Gs          , Gs          , Gs          , Gs          , Gg          , Gg          , Gg          , Gd          , Rb          , Rb          , Rp          , Gs          , Gg          , Gs          , Gg          , Gg          , Gs          , Gs          , Gg          , Gg          , Gs^Vl       , Gs^Fds      , Gs^Fds      , Gs^Fds      , Gs^Fds      , Gs^Fds      , Gs^Fms      , Xv          , Xv          , Xv          , Xv          , Xv          , Xv          , Xv          , Xv          
Gs          , Gd          , Gd          , Gs          , Gd          , Gs          , Re          , Re          , Gs          , Gg          , Gs          , Gs          , Gd          , Gs          , Gs          , Gg          , Gs          , Gs          , Gs          , Gg          , Hhd         , Gs          , Gs          , Rb          , Rb          , Rb          , Gs          , Gg          , Gs          , Gs          , Gs          , Gs          , Gg          , Gg          , Gs          , Gg          , Gg          , Gs^Fms      , Gg          , Gg          , Gg          , Gs^Fds      , Xv          , Xv          , Xv          , Xv          , Xv          , Xv          , Xv          , Xv          
Gs          , Gs          , Gg          , Gs          , Gs          , Gs          , Gs          , Gs          , Hhd         , Hhd         , Gs          , Gs          , Gs          , Gd          , Gs          , Gs          , Gs          , Gs          , Gs          , Hhd         , Gd          , Hhd         , Gs          , Rb          , Rb          , Rb          , Gs          , Gs^Vc       , Gs          , Gs          , Gd          , Gs          , Gs          , Gg          , Gs^Fds      , Gs^Fds      , Gs          , Gg          , Gs^Fds      , Gs^Fds      , Gg          , Gs          , Xv          , Xv          , Xv          , Xv          , Xv          , Xv          , Xv          , Xv          
Gll         , Gg          , Gs          , Gg          , Gs          , Gs          , Gs          , Gd          , Gd          , Gd          , Gs          , Gs          , Gs          , Gs          , Gs          , Gd          , Gd          , Gs          , Gs          , Gs          , Gs          , Gs          , Gs          , Gd          , Rb          , Rb          , Gs          , Gd          , Gd          , Gd          , Gd          , Gs          , Gs          , Gs          , Gs          , Gll         , Gg          , Gs          , Gg          , Gs^Fds      , Gg          , Gg          , Xv          , Xv          , Xv          , Xv          , Xv          , Xv          , Xv          , Xv          
Gs          , Gs          , Gll         , Gs^Vc       , Gs          , Gg          , Gs          , Gd          , Gd          , Gs          , Gs          , Gg          , Re          , Gs          , Gd          , Gs          , Gd          , Gd          , Gd          , Gd          , Gs          , Gs          , Gg          , Gs          , Rp          , Rb          , Gll         , Gd          , Hhd         , Gd          , Gs          , Gg          , Re          , Gll         , Gd          , Gs          , Gd          , Gg          , Gll         , Gs          , Gg          , Gs          , Xv          , Xv          , Xv          , Xv          , Xv          , Xv          , Xv          , Xv          
Gs          , Gs          , Gd          , Gd          , Gs          , Gs          , Gs          , Gd          , Gll         , Gll         , Gs          , Gd          , Re          , Gg          , Gs          , Gll         , Gll         , Gd          , Gg          , Gs          , Gs          , Gs          , Gd          , Gs          , Rb          , Rb          , Gs          , Gs          , Hhd         , Hhd         , Re          , Re          , Re          , Gs          , Gd          , Gd          , Gs          , Gs          , Gll         , Gll         , Gs          , Gs          , Xv          , Xv          , Xv          , Xv          , Xv          , Xv          , Xv          , Xv          
Gg          , Gd          , Gd          , Gd          , Gs          , Gll         , Gd          , Gs          , Gs          , Gs          , Re          , Gs          , Ce          , Re          , Re          , Gs          , Gs          , Gg          , Gg          , Gg          , Gs          , Gs          , Gs          , Gs          , Rb          , Rb          , Gd          , Gs          , Gg          , Gg          , Re          , Re          , Ce          , Re          , Re          , Re          , Re          , Gs          , Re          , Gs          , Gs          , Gg          , Xv          , Xv          , Xv          , Xv          , Xv          , Xv          , Xv          , Xv          
Gd          , Gd          , Gd          , Gs          , Gs          , Gd          , Gd          , Gd          , Re          , Re          , Re          , Ce          , Ce          , Re          , Ce          , Re          , Ce          , Re          , Gs          , Gs          , Gd          , Gs          , Gs          , Gd          , Rb          , Rb          , Gll         , Gs          , Gd          , Gg          , Re          , Ce          , Ce          , Ce          , 1 Ke        , Ce          , Re          , Gs          , Gg          , Gs          , Gs          , Gs          , Xv          , Xv          , Xv          , Xv          , Xv          , Xv          , Xv          , Xv          
Hhd         , Hhd         , Gs          , Gs          , Gs          , Gd          , Gll         , Gd          , Gs          , Re          , Re          , Ce          , Ce          , Ce          , 2 Ke        , Ce          , Ce          , Re          , Gd          , Gd          , Gs          , Gd          , Gs          , Gs          , Rb          , Rb          , Rb          , Gs          , Gs          , Re          , Re          , Re          , Gs          , Ce          , Re          , Re          , Gs          , Gs          , Gs          , Gs          , Gs          , Gs          , Xv          , Xv          , Xv          , Xv          , Xv          , Xv          , Xv          , Xv          
Hhd         , Hhd         , Gll         , Gs          , Gg          , Gg          , Gs          , Gs          , Gs          , Gg          , Gs^Vc       , Gs          , Re          , Re          , Re          , Re          , Gs          , Gs          , Gs          , Gd          , Gll         , Gs          , Gs          , Gs          , Gs          , Rb          , Rb          , Gs          , Gll         , Gs          , Gs          , Re          , Re          , Gs          , Re          , Gs          , Gs^Vc       , Gd          , Gd          , Gd          , Gg          , Gs          , Xv          , Xv          , Xv          , Xv          , Xv          , Xv          , Xv          , Xv          
Gs          , Gd          , Gs          , Gg          , Gs          , Gd          , Gll         , Gd          , Gd          , Gs          , Gs          , Gg          , Gs          , Re          , Gd          , Gs          , Re          , Re          , Gll         , Gll         , Gll         , Gs          , Gd          , Gs          , Gs          , Rb          , Rb          , Gs          , Gd          , Gd          , Gd          , Gs          , Gg          , Gd          , Gs          , Gs          , Gd          , Gd          , Gd          , Gs          , Gs          , Gg          , Xv          , Xv          , Xv          , Xv          , Xv          , Xv          , Xv          , Xv          
Gs          , Gs          , Gs          , Gs          , Gs          , Gs          , Gs          , Gg          , Gs          , Gs          , Gs          , Gs          , Gs          , Gd          , Gs          , Gs          , Gs          , Gs          , Gs          , Gs          , Gd          , Gd          , Gd          , Gd          , Gs          , Rb          , Rb          , Gs          , Gs          , Gs          , Gs          , Gs          , Gs          , Gs          , Gs          , Gs          , Gs          , Gd          , Gd          , Gd          , Gs          , Gs          , Xv          , Xv          , Xv          , Xv          , Xv          , Xv          , Xv          , Xv          
